####################
##########__S_######
#########____#######
########____########
########____########
########____########
########____########
#######______#######
#######______#######
######________######
######________######
#####__________#####
#####__________#####
####____________####
####____________####
####_____DD_____####
####______*_____####
####################
####################
####################