00000000000000000000
0###################
^#$$$$$$$$$$$$$$$$$#
^#__D__D__D__D_____#
^#__D__D__D__D_____#
^#_________________#
^#__D__D__D__D_____#
^#__D__D__D__D_____#
^#________________|_
^#__D__D__D__D_____#
^#__D__DS_D__D_____#
^#_________________#
^#__D__D__D__D_____#
^#__D__D__D__D_____#
^#_________________#
^#__D__D__D__D_____#
^#__D__D__D__D_____#
^#_________________#
0###################
0###################