####################
####################
#__________________#
#___D__D__D__D_____#
#___D__D__D__D_____#
#__________________#
#___D__D__D__D_____#
#___D__D__D__D_____#
#__________________|
#___D__D__D__D_____#
#___D__DS_D__D_____#
#__________________#
#___D__D__D__D_____#
#___D__D__D__D_____#
#__________________#
#___D__D__D__D_____#
#___D__D__D__D_____#
#__________________#
####################
####################