00000000000000000000
0###################
^#$$$$C$$$$$$$$&$$$#
^#__D__D__D__D__J__#
^#__$__$__C__$_____#
^#_________________#
^#__D__D__D__D_____#
^#__$__$__$__$_____#
^#________________|_
^#__D__D__D__D_____#
^#__$__DS_$__$_____#
^#_________________#
^#__D__D__D__D_____#
^#__$__$__$__$_____#
^#_________________#
^#__D__D__D__D_____#
^#__$__$__$__$_____#
^#_________________#
0###################
0###################