00000000000000000000
0###################
0#$$$$$$$$$$$$$$$$$#
0#__D__D__D__D_____#
0#__D__D__D__D_____#
0#_________________#
0#__D__D__D__D_____#
0#__D__D__D__D_____#
0#_________________|
0#__D__D__D__D_____#
0#__D__DS_D__D_____#
0#_________________#
0#__D__D__D__D_____#
0#__D__D__D__D_____#
0#_________________#
0#__D__D__D__D_____#
0#__D__D__D__D_____#
0#_________________#
0###################
0###################