00000000000000000000
####################
####################
####################
####################
####################
#$$$$$##############
#_____$$$&$$$$$$$$$#
_S__________V_____|_
#_____#####_X#######
###########__#######
####################
####################
####################
#$$$&$$$############
_|______############
######$_$###########
######___###########
######___###########
#######_############