#############$$$$#00
#$$$$$$$$$###__S_#00
_|__V_XV__###____#00
#####_#X#_$$$$$_##00
#####_$_$_______##00
#####_____########00
##################00
##################00
##################00
##################00
##################00
##################00
##################00
##################00
##################00
##################00
##################00
##################00
##################00
##################00