####################
####################
####################
#__________________#
#__________________#
#__________________#
#___D__D__D________#
#___D__D__D________#
#__________________#
#___D__D__D________#
#___D__DS_D________#
#__________________#
#___D__D__D________#
#___D__D__D________#
#__________________#
#___D__D__D________#
#___D__D__D________#
#__________________#
####################
####################