--------------------
-X_________________-
--------___________-
-______-___________-
-______-___________-
-______-___________-
-______-__X________-
-___D__D__D________-
-__________________-
-___D__D__D________-
-___D__DS_D________-
-__________________-
-___D__D__D________-
-___D__D__D________-
-__________________-
-___D__D__D________-
-___D__D__D________-
-__________________-
-__________________-
--------------------