00000000000000000000
####################
####################
####################
####################
####################
#$$$$$##############
#_____$$$&$$########
_S__________########
#_____#####_########
###########_########
##$$$######_########
#$___$$$$$$_########
___E___XXX__$$$&$$$#
##___######V______|_
####################
####################
####################
####################
####################