00000000000000000000
##################00
##################00
##################00
##################00
##################00
##################00
##################00
##################00
##################00
##################00
##################00
#$$$$$#####$$#####00
#_____$$#$$__$$$##00
#S______$_XX____##00
#______XX_X__##_##00
########____X##_##00
########_XX_E##_##00
###############|##00
###############_##00