00000000000000000000
####################
####################
####################
####################
####################
#$$$$$##############
#____J$$$$$$$$&$$$$#
_S________X_______|_
#_________X__###$$$#
#############$$$J__#
###$$##$&$$##______#
###__$$____$$_##___#
###_____V_____##$$$#
#$$_$$_$$_$$_$$$___#
_|V__V_____VX_______
####____##____##___#
####################
####################
####################