####################
####################
####################
####################
####################
####################
####################
#_____##############
#S___P______########
#_____#####_########
###########_########
###########_########
##___######_########
_______XXX__########
##___######V_______|
####################
####################
####################
####################
####################