####################
####################
####################
####################
####################
####################
####################
#_____##############
#________X__##_____|
#_____####_###_#####
##########_____#####
####################
####################
####################
################___#
###############___S#
##############____##
#############____###
############____####
###########||||#####