####################
####################
####################
####################
####################
####################
####################
#_____##############
#@_______X_________|
#________X___#######
##########___#######
####################
####################
####################
####################
####################
####################
####################
####################
####################