####################
####################
####################
####################
####################
####################
####################
####################
####################
####################
####################
####################
####################
#_____#####__#######
#S______#_XX_______|
#______XX_X__#######
########____X#######
########_XX_E#######
####################
####################