####################
################___#
##########________@#
##########_#####___#
##########_#########
##########_#########
##########_###____##
##########VXX___E_##
##########_###____##
##########__####_###
###########__XXXV###
#____#######_###_###
|________###_XXX_###
#____###____V###_###
################_###
################_###
################_###
################_###
################_###
################_###