00000000000000000000
####################
####################
####################
####################
####################
#$$$$$##############
#_____$$$$$$$$$$$$$#
#S___P______V_____|_
#_____#####_X#######
###########__#######
####################
####################
####################
#$$$$$$$############
_|______############
######$_$###########
######___###########
######___###########
####################