####################
####################
####################
####################
####################
####################
####################
#_____##############
#S________X________|
#_________X__#######
################___#
#############______#
###__##____##_##___#
###_____V_____######
###_##_##_##_###___#
|V___V_____VX______#
####____##____##___#
####################
####################
####################