#############$$$$#00
#$$$$$$$$$###__S_#00
_|__v_xv__###____#00
#####_#x#_$$$$$_##00
#####_$_$_______##00
#####_____########00
##################00
##################00
##################00
##################00
##################00
##################00
##################00
##################00
##################00
##################00
##################00
##################00
##################00
##################00