####################
####################
####################
####################
####################
####################
####################
####################
####################
####################
####################
####################
####################
#_____#####__#######
#S______#_XX____####
#______XX_X__##_####
########____X##_####
########_XX_E##_####
###############_####
###############|####