00000000000000000000
####################
####################
####################
####################
####################
#$&$$$##############
#_____$$$$$$##$$$$$#
#S_______X__##____|_
#_____####_$$$_#####
##########_____#####
####################
####################
################$$$#
###############$___#
##############$____#
#############$____##
############$____###
###########$____####
###########||||#####