################$$$#
##########$$&$$$___#
##########________S_
##########_#####___#
##########_#########
##########_###$$$$##
##########_$$$____##
##########VXX___E_##
##########_$##____##
##########__$$$$_###
#$$&$######__XXXV###
#____$C$$###_$$$_###
_|_______$$$_XXX_###
#____###____V###_###
################_###
################_###
################_###
################_###
^^^^^^^^^^^^^^^^^^^^
^^^^^^^^^^^^^^^^^^^^