00000000000000000000
####################
####################
####################
####################
####################
#$$$$$##############
#_____$$$$$$########
#S___P______########
#_____#####_########
###########_########
##$$$######_########
#$___$$$$$$_########
___E___XXX__$$$$$$$#
##___######V______|_
####################
####################
####################
####################
####################