########|###########
########_###########
########_###########
########_###########
####V###_###########
###_____V###########
###__###_###########
####_###_###########
####_###_###########
####V###_###########
####V###_###########
####V###_#######___#
####VXXXXXXX______S#
##____##########___#
______##############
##____##############
####################
####################
####################
####################