####################
####################
####################
####################
####################
####################
####################
#_____##############
#____P______V______|
#_____#####_X#######
###########__#######
####################
####################
####################
####################
|_______############
#######_############
######___###########
######_S_###########
####################