00000000000000000000
####################
####################
####################
####################
####################
#$$$$$##############
#_____$$$$$$##$$$$$#
_________X__##____|_
#_____####_$$$_#####
##########_____#####
####################
####################
################$$$#
###############$___#
##############$___S_
#############$____##
############$____###
###########$||||####
###########____#####