00000000000000000000
####################
####################
####################
####################
####################
#$$&$$##############
#_____$$$&$$$$$$$$$#
_____P______V_____|_
#_____#####_X#######
###########__#######
####################
####################
####################
#$$$&$$$############
_|______############
######$_$###########
######___###########
######_S_###########
#######_############