00000000000000000000
####################
####################
####################
####################
####################
#$$$$$##############
#_____$$$$$$$$$$$$$#
#S___P______V______|
#_____#####_X#######
###########__#######
####################
####################
####################
#$$$$$$$############
|_______############
######$_$###########
######___###########
######___###########
####################