00000000000000000000
00000000>00000000000
00000000000000000000
000000000000>0000000
00000000000000000000
00000000000000000000
#$$$$$00000000000000
#_____$$$$$$$$$$$$$$
#_________X________|
#_________X__###$$$#
#############$$$___#
###$$##$$$$##______#
###__$$____$$_##___#
###_____V_____##$$$#
#$$_$$_$$_$$_$$$___#
|V___V_____VX_____S#
####____##____##___#
####################
00000000000000000000
000000000000>0000000