####################
#^^^^^###$__S_######
#^^^^^##$____#######
#^^^^###____########
########____########
########____########
#######$____$#######
#######______#######
######$______$######
######________######
#####$____X___$#####
#####_____V____#####
####$__________$####
####____________####
####____________####
####______D_____####
####______*_____####
####################
####^^^^^^^^^^^^^^^^
####^^^^^^^^^^^^^^^^