00000000000000000000
####################
####################
####################
####################
####################
#$$$$$##############
#_____$$$$$$$$$$$$$#
#____P______V______|
#_____#####_X#######
###########__#######
####################
####################
####################
#$$$$$$$############
|_______############
######$_$###########
######___###########
######_S_###########
####################