00000000000000000000
####################
####################
####################
####################
####################
#$$$$$##############
#_____$$$$$$##$$$$$#
#________X__##_____|
#_____####_$$$_#####
##########_____#####
####################
####################
################$$$#
###############$___#
##############$___S#
#############$____##
############$____###
###########$____####
###########||||#####