00000000000000000000
####################
####################
####################
####################
####################
#$$$$$##############
#_____$$$$$$$$$$$$$$
#_________X_______|_
#_________X__###$$$#
#############$$$___#
###$$##$$$$##______#
###__$$____$$_##___#
###_____V_____##$$$#
#$$_$$_$$_$$_$$$___#
_|V__V_____VX_____S#
####____##____##___#
####################
####################
####################