####################
####################
####################
####################
####################
####################
####################
#_____##############
#S_______X_________|
#________X___#######
##########___#######
####################
####################
####################
####################
####################
####################
####################
####################
####################